1111111111111
10000000000C1
1C00C11111111
1P0011E000011
1111111111111