1111111111111
1001000001C11
1000011110101
1P0011E000001
1111111111111