111111111111111
10010000C00C001
1000011111000E1
1P0011000001001
111111111111111