1111111111111
1001000001EC1
1000011101001
1P00110000011
111111111111