1111111111111
10010000001C1
1C00011101111
1P0011E000011
1111111111111