111111111111111
100100000C1C101
1000011111010E1
1P0011000001001
111111111111111