11111111111111111111111111111111111111111
10010000C00C00000000000000000000000000001
10000111110000000000000000000000000000001
10000111110000000000000000000000000000001
10000111110000000000E00000000000000000001
1P001100000100000000000000000000000000001
11111111111111111111111111111111111111111